111111111
1S0000001
100000001
100000001
100000001
100000001
100000001
100000001
1000000G1
111111111
