111111111
1S0010001
100010001
100000001
100000001
100000001
100000001
100010001
1000100G1
111111111
