111111111
1S0000001
101000111
101000101
100000001
100000001
100100011
10010G001
100100001
111111111
