11111111111
1S000000001
10100001011
10101110001
10010010001
11000001011
10010010001
10111100001
100001G0001
11111111111
