111111111111111
100000000000001
101010101010101
101010101010101
101010101010101
100000000000001
101010101010101
101G1010101S101
101010101010101
100000000000001
101010101010101
101010101010101
101010101010101
100000000000001
111111111111111
