111111111111111
100000010000001
100000001011101
1000G0001000001
110000001011101
101000010000001
101110111011101
100000010000001
101111101111101
1000000S0000001
101110101011101
100000010000001
111111111111111
